山	shan
黄	huang
河	he
静	jing
美	mei
可	ke
刚	gang
丽	li
明	ming
云	yun
周	Zhou
词语	ciyu
各	ge
举行	juxing
可乐	kele
秘书	mishu
情况	qingkuang
生活	shenghuo
睡着	shui zhao
办事	ban shi
变	bian
春节	Chunjie
打	da
到时候	dao shihou
房子	fangzi
歌舞	gewu
红酒	hongjiu
酒	jiu
句	ju
每天	mei tian
哪里	nali
女孩儿	nühair
女孩	nühai
钱包	qianbao
人名	ren ming
认	ren
听说	tingshuo
外地	waidi
鲜花	xianhua
香瓜	xianggua
一般来说	yiban lai shuo
音乐会	yinyuehui
有点儿	youdianr
有点	youdian
早	zao
怎么办	zenme ban
照	zhao
中秋节	Zhongqiu Jie

